1111111111111111111111111111111111
100000000000000000000C000000000001
1111111100100000101001000000010101
100P01001010101C001E00000000010101
1000000000000000000000000000000C11
1111111111111111111111111111111111