111111111
100C00001
101000E01
1P0000001
111111111