1111111111111111111111111111111111
1000G0000000000000000C000000G00001
1111111100100000101001000000010101
100P01001010101C001E0G000000010101
100000000000000000000000000000GC11
1111111111111111111111111111111111