1111111111111111111
1000010000C000G0001
1C00E00P00C00000001
1C00000000C00000001
1C000G0000C00000001
1C00000000C11111001
1C00000000C01C01001
1C0000G000C01111001
1C00000000C00C01001
1C00000000C00C01001
1111111111111111111